46 26
14 39 0 0 7 0 3 24 0 0 0 5 4 0 0 26 0 21 40 5 0 3 0 6 21 0 0 9 0 0 0 5 0 1 0 21 0 5 13 13 28 43 0 0 0 0
0 2 60 19 20 0 20 13 10 26 0 19 9 9 3 7 0 0 34 1 12 4 0 0 0 0 38 13 7 11 13 1 0 2 20 29 0 0 20 18 13 15 0 41 0 0
0 0 35 19 0 9 14 5 0 7 3 0 13 23 9 0 11 0 9 8 4 36 19 4 0 0 0 25 0 0 0 0 6 25 0 1 18 0 6 6 0 6 0 0 23 0
0 19 8 20 42 3 30 20 5 0 0 0 0 35 0 0 25 14 1 18 0 8 0 2 7 0 0 0 0 0 21 0 0 20 14 2 0 17 17 17 0 1 0 36 0 38
0 10 28 31 0 0 0 0 3 0 0 2 2 0 43 16 3 0 34 1 3 0 8 3 18 0 0 0 13 0 28 8 0 0 16 32 0 3 0 9 22 0 5 0 0 0
0 0 0 31 0 11 25 52 0 0 16 0 2 0 0 0 37 11 0 16 12 0 0 26 0 14 9 0 1 0 1 13 30 0 24 9 0 3 0 14 0 20 0 36 5 14
9 7 28 36 0 26 4 31 0 0 4 12 0 0 6 0 0 0 0 18 6 0 17 6 11 0 0 3 8 15 18 0 0 6 0 6 33 32 5 3 0 12 17 5 0 23
0 0 0 38 18 7 5 0 0 0 4 11 24 0 3 16 13 5 0 5 0 16 0 0 0 0 0 18 0 5 0 16 15 18 1 5 0 16 2 14 0 38 0 0 7 33
27 2 0 29 0 0 0 0 0 7 0 0 7 13 0 24 12 0 3 0 0 16 0 22 0 0 3 0 11 0 29 15 29 7 0 0 1 16 0 17 47 0 27 12 0 0
26 0 0 12 1 22 2 0 0 7 4 0 0 31 15 12 7 0 0 7 0 0 21 0 0 9 47 6 3 0 0 0 0 1 0 0 31 0 2 2 0 0 19 26 55 0
47 0 0 0 0 0 9 0 0 0 4 8 3 7 9 5 0 11 0 40 6 9 0 0 2 5 0 0 4 10 0 0 0 32 0 13 0 22 0 4 0 0 27 1 5 5
24 39 8 0 0 0 0 0 0 0 30 29 14 2 0 0 3 0 0 0 6 8 0 23 0 7 3 12 0 9 0 6 0 0 0 0 0 28 9 10 44 0 0 0 13 35
61 0 29 9 81 22 15 43 30 0 52 29 3 21 15 29 2 6 4 24 39 2 2 11 8 18 0 31 7 2 6 43 10 0 2 34 0 0 45 34 38 25 31 37 26 26
0 8 1 0 0 0 0 0 17 0 0 0 30 0 0 0 0 0 0 0 11 23 0 12 14 2 0 0 4 0 0 0 12 0 0 0 7 2 14 4 0 0 17 10 11 0
1 0 0 3 26 15 7 3 0 0 20 11 3 5 13 23 9 9 1 0 32 0 37 24 6 0 7 12 4 11 19 0 0 35 13 4 0 2 30 4 0 12 0 0 7 0
22 7 14 15 0 5 20 0 0 9 0 2 12 0 0 0 12 6 15 24 0 24 22 3 15 26 20 15 14 0 0 8 0 0 0 3 0 0 0 0 0 20 0 30 49 5
0 0 0 0 0 0 8 0 0 0 5 0 0 0 23 0 10 0 10 4 0 4 0 0 15 1 3 5 10 6 13 0 13 0 0 6 1 24 7 0 5 0 0 13 0 13
28 7 0 0 0 4 6 0 7 0 0 0 0 5 8 8 0 3 9 8 0 8 30 0 0 0 8 0 0 24 0 18 0 0 7 0 0 9 0 12 5 0 0 14 0 0
0 23 0 0 37 34 4 57 0 0 0 11 7 2 0 1 0 0 18 0 4 0 0 6 6 6 0 0 10 0 0 5 9 43 2 0 0 6 31 34 25 2 31 0 0 4
0 0 0 0 28 0 18 0 30 0 0 17 18 5 1 0 0 23 0 0 0 16 0 0 0 0 0 0 23 0 0 0 23 0 3 2 0 5 30 18 23 6 0 0 0 1
0 4 0 19 6 5 0 0 13 21 1 19 5 0 5 0 0 22 0 8 10 13 0 21 0 0 0 4 2 10 19 0 15 0 0 0 25 4 20 7 0 0 0 12 28 0
1 1 39 34 37 19 6 19 0 0 0 0 2 0 2 24 0 0 4 11 19 11 0 33 0 0 0 0 0 2 0 1 11 0 17 26 0 20 7 27 0 37 0 0 6 22
21 0 0 28 8 19 7 29 28 0 10 0 4 0 1 3 11 0 0 17 21 26 12 5 19 0 1 9 5 13 0 12 13 9 40 0 14 42 0 12 0 0 4 0 0 0
0 21 55 0 0 11 17 0 0 18 28 0 0 17 13 0 0 0 0 6 0 16 2 7 2 0 3 28 4 0 0 8 0 51 0 22 0 47 21 15 0 9 0 10 22 23
9 18 0 0 1 15 7 5 0 31 19 0 0 24 33 0 27 0 12 13 5 0 0 42 0 0 36 2 0 12 9 22 9 7 6 4 0 26 0 0 0 0 8 7 2 0
19 10 11 21 26 4 17 5 5 0 12 1 48 37 20 11 28 0 25 19 17 0 12 12 4 0 0 11 4 17 8 0 16 28 8 0 0 31 8 0 37 6 8 0 31 20
