46 26
29 0 0 0 0 52 18 0 2 36 35 2 15 11 0 0 16 9 12 11 0 0 35 0 14 9 0 0 23 12 0 14 19 0 13 0 7 8 33 25 18 19 18 19 10 65
0 37 27 0 0 0 16 0 0 19 17 17 0 0 21 0 0 1 3 6 0 23 0 0 0 11 0 0 0 26 5 0 0 21 0 39 25 4 53 0 11 0 0 0 23 0
37 0 48 0 8 21 0 0 37 28 0 12 8 14 0 0 0 0 14 12 17 17 18 10 20 0 2 32 17 13 0 18 11 23 16 0 0 26 6 14 0 0 0 11 11 19
35 28 0 10 4 9 0 6 16 0 30 0 0 16 33 0 0 0 24 0 0 0 13 0 0 33 15 4 1 17 11 18 14 0 14 0 0 0 0 6 51 21 17 7 0 6
24 18 70 0 5 17 0 34 26 0 35 18 27 0 0 0 0 7 1 32 0 0 13 0 6 0 0 0 30 0 21 10 0 31 17 0 1 23 26 0 0 38 0 0 0 35
33 7 0 4 0 11 0 0 0 18 0 24 7 0 17 0 14 24 0 0 12 0 14 1 0 0 5 0 0 20 0 5 10 30 11 6 1 22 6 0 0 24 5 0 0 11
7 0 17 0 12 3 11 52 0 0 1 17 0 9 0 5 0 11 0 0 0 0 0 15 0 5 0 0 0 0 24 14 0 0 0 0 0 13 0 0 0 3 35 0 2 14
0 0 0 42 37 17 13 0 0 0 1 15 4 7 10 30 0 0 18 15 0 0 2 55 7 22 0 4 0 0 8 20 0 0 2 0 11 0 0 31 0 29 19 1 1 18
0 5 12 12 0 2 87 2 0 0 4 49 4 20 25 0 0 0 7 0 0 0 0 0 16 10 0 5 6 0 0 0 0 3 0 10 25 0 33 33 0 0 22 73 54 0
0 0 0 17 8 12 32 14 0 0 0 49 0 9 12 0 6 23 0 0 13 7 3 0 15 6 12 0 0 26 0 14 10 22 0 0 6 31 0 8 8 0 6 0 0 0
0 34 26 32 14 11 2 7 0 3 0 2 6 0 19 0 0 14 10 8 0 11 21 0 2 0 0 26 16 11 9 30 22 0 0 0 0 6 10 35 0 40 0 8 1 0
14 57 0 0 0 0 9 8 19 0 0 2 4 35 2 3 12 5 1 3 25 13 3 10 13 0 2 10 9 7 0 14 0 0 0 21 0 0 24 0 0 0 0 27 5 69
35 22 15 0 0 0 0 0 0 0 0 0 12 23 7 22 0 18 0 0 4 0 7 33 10 0 0 0 0 0 41 0 0 0 0 0 0 0 0 18 23 28 42 0 29 0
10 0 6 25 0 0 28 0 10 0 0 2 0 0 0 12 6 0 2 7 0 0 7 1 0 0 17 12 0 0 5 28 44 0 28 6 0 0 0 2 11 4 0 13 6 6
0 28 0 0 0 0 17 10 0 0 0 10 0 0 3 0 19 52 0 9 0 17 0 24 0 20 1 12 20 64 9 0 0 0 9 4 0 0 17 38 19 0 26 0 7 0
28 9 0 0 0 19 27 7 0 42 0 37 12 0 18 1 0 12 5 0 5 0 5 25 15 0 15 0 28 8 1 17 0 11 0 0 37 0 0 28 31 8 0 17 11 0
4 0 28 41 0 0 0 0 0 19 2 8 10 0 0 0 0 0 0 14 20 0 37 0 0 40 0 8 32 0 58 6 0 0 20 0 42 0 0 36 20 16 8 0 0 7
0 0 18 0 0 17 12 22 21 8 9 18 0 1 4 0 0 12 4 9 8 0 0 21 22 5 0 7 0 40 6 0 21 0 21 2 30 2 16 15 4 0 0 0 17 6
0 0 0 30 26 0 7 8 0 1 5 0 31 6 0 39 0 0 0 1 0 11 8 0 8 0 3 0 0 0 8 0 8 47 0 0 0 14 34 6 0 0 10 31 0 30
75 44 9 0 0 3 11 33 0 3 0 0 5 0 23 13 14 6 0 41 0 2 19 7 0 16 0 30 0 3 18 26 10 3 29 63 38 21 0 0 37 25 0 20 9 46
17 0 27 0 0 21 2 11 22 6 7 0 0 0 1 9 0 1 11 0 0 0 5 3 0 4 3 0 0 19 37 11 0 0 49 3 0 0 7 0 1 0 0 1 1 10
0 0 10 0 0 15 13 0 0 20 0 1 44 0 4 0 13 0 24 12 18 0 20 21 20 1 0 0 0 4 0 19 8 20 9 0 31 0 18 0 9 0 36 19 0 33
16 0 15 30 4 0 0 0 6 1 0 0 0 0 17 0 0 0 0 1 16 0 0 17 20 0 2 0 20 0 0 0 11 0 0 3 0 0 0 0 0 0 0 11 0 0
0 0 14 0 2 7 20 0 6 3 1 28 0 12 4 4 0 0 22 0 0 0 18 30 10 2 10 14 23 1 15 2 13 28 0 0 18 1 2 0 35 33 23 0 0 17
39 9 38 0 36 17 0 0 0 1 8 28 2 17 26 0 0 0 22 0 0 0 0 0 12 0 0 5 0 11 26 17 0 0 0 7 0 0 27 51 23 0 28 0 16 0
0 0 0 0 14 45 0 15 0 19 0 34 0 14 4 5 27 0 36 0 16 7 3 2 11 9 0 0 10 28 2 0 12 1 10 0 9 15 0 0 0 0 0 14 15 34
