44 25
20 16 0 2 2 9 2 0 0 15 0 33 13 23 18 0 0 26 0 0 21 1 23 0 16 14 20 0 0 6 0 2 0 0 0 11 19 12 4 2 59 5 4 6
0 1 0 20 16 0 8 16 0 0 1 36 0 0 15 33 0 8 17 0 24 0 0 70 4 8 6 0 0 1 18 0 13 0 0 12 21 0 19 0 0 0 0 0
0 0 11 0 2 0 14 0 0 0 12 0 0 1 7 27 0 7 11 12 11 26 0 0 32 12 16 0 1 2 4 28 14 29 4 0 0 13 0 2 14 0 27 36
0 0 0 0 18 0 0 19 2 1 2 6 8 11 0 19 23 11 0 32 31 5 17 3 34 1 5 18 11 0 0 0 0 0 23 0 0 0 3 5 1 37 0 19
0 41 22 1 0 53 37 16 0 4 0 0 0 4 8 0 1 0 0 0 0 0 14 5 2 2 14 8 0 5 0 10 2 4 0 4 31 15 0 0 0 10 0 5
0 42 0 9 29 34 16 0 8 10 6 8 29 0 13 1 5 18 10 8 13 0 2 1 7 9 0 12 10 0 19 0 0 29 0 0 0 0 2 34 0 13 0 42
36 13 0 7 0 0 10 31 0 0 0 15 0 1 0 25 20 16 0 0 26 0 8 0 0 14 0 11 4 12 4 14 6 16 15 20 0 0 69 14 20 12 0 6
0 3 0 6 0 12 12 0 6 0 4 4 15 10 23 36 0 8 0 8 0 0 7 1 7 23 12 12 27 14 0 29 17 0 10 10 0 5 13 0 0 0 11 0
14 13 35 0 11 0 4 16 4 0 0 35 9 24 4 13 32 0 22 0 7 19 0 4 19 5 8 7 22 12 23 11 0 4 6 15 0 24 3 9 38 37 3 0
0 11 14 0 30 37 0 6 0 42 16 0 0 7 0 28 1 5 0 23 7 0 0 0 23 0 29 3 6 12 0 7 10 8 30 16 0 0 3 10 30 1 0 25
39 0 0 11 36 24 0 0 4 0 0 0 0 0 11 10 11 0 0 28 17 7 4 11 3 7 4 0 7 10 11 0 16 0 25 2 0 17 19 5 8 0 0 0
40 0 15 0 1 0 0 22 27 21 4 14 17 0 20 3 12 0 13 0 0 10 0 0 2 8 2 25 2 25 24 5 8 0 8 1 0 0 0 6 32 2 0 0
4 12 9 7 0 27 0 0 6 0 0 0 15 0 19 11 20 4 4 8 0 0 0 19 13 0 1 11 25 0 0 8 43 0 11 0 53 32 3 0 5 0 0 7
5 3 7 28 34 28 4 37 0 7 0 0 5 0 29 47 9 1 11 0 15 8 8 0 0 8 0 0 0 12 0 0 3 1 13 95 33 0 0 34 0 14 0 9
23 0 10 0 0 9 0 0 0 0 1 7 13 11 28 4 0 24 6 12 0 6 8 23 5 8 7 0 3 2 0 3 16 17 0 6 5 0 0 0 0 34 28 0
0 0 0 12 38 0 0 1 6 10 0 7 0 19 7 12 17 0 0 34 0 7 16 0 0 0 0 6 0 1 0 0 0 0 0 0 0 24 16 0 0 22 59 13
0 0 15 0 0 0 10 16 59 8 0 0 23 9 34 15 0 11 5 13 3 0 17 12 0 12 7 12 0 9 23 20 0 2 15 4 0 0 0 11 26 0 34 0
0 5 0 0 17 0 5 0 7 0 0 0 9 2 0 0 17 8 0 6 11 17 0 0 5 18 0 14 0 0 0 0 3 14 0 15 0 10 0 0 1 0 0 18
38 0 33 48 13 0 5 5 12 15 0 33 10 0 10 16 7 14 17 9 0 21 0 4 6 14 13 12 0 0 0 0 12 0 0 3 4 0 25 10 0 39 33 0
0 6 31 0 14 15 9 0 47 0 13 5 34 2 16 1 5 5 3 0 3 0 15 35 15 10 13 21 0 2 0 2 8 0 11 1 19 5 30 13 40 0 8 0
0 0 9 0 0 34 0 16 0 0 0 9 0 0 4 0 22 22 0 2 15 14 0 16 0 0 13 15 0 0 0 10 9 0 18 14 0 8 3 69 20 0 5 0
13 0 1 0 23 22 16 0 0 29 9 17 0 27 0 7 7 0 14 9 16 19 0 1 3 0 0 25 5 12 19 0 2 36 15 0 0 0 27 19 9 23 39 14
38 0 41 0 19 1 0 19 0 0 32 0 5 20 0 28 0 0 0 0 0 13 19 0 5 0 0 15 0 4 0 6 28 24 11 0 3 0 38 17 19 0 17 12
19 35 2 7 23 29 22 0 0 0 0 0 9 8 0 17 0 18 0 14 0 21 32 0 1 22 5 19 16 0 0 0 28 0 12 0 34 19 0 7 0 1 15 1
0 35 0 16 6 52 0 10 0 7 2 8 45 19 1 0 0 0 0 10 7 0 0 18 23 5 8 8 14 8 14 17 19 7 8 8 23 27 33 29 22 40 41 1
