42 24
0 64 0 0 29 35 0 3 7 0 0 19 17 0 3 7 6 6 0 0 0 16 19 6 1 14 4 1 0 0 0 0 11 20 0 37 24 0 37 2 0 7
0 0 25 0 0 0 29 15 10 0 0 28 26 5 2 12 14 0 8 19 11 2 32 0 15 4 14 28 13 5 18 15 0 1 15 25 3 0 0 28 0 0
15 19 6 42 37 9 0 7 14 19 7 25 0 19 4 15 5 2 0 5 2 30 10 0 0 6 0 0 6 5 0 30 4 20 31 0 0 10 0 0 0 37
11 22 0 29 16 11 31 39 40 5 0 5 6 4 1 0 7 9 4 36 4 20 9 11 0 22 12 0 0 1 47 6 44 0 5 1 12 74 19 35 11 10
0 38 0 0 0 27 7 13 0 0 0 19 0 7 0 0 1 0 0 0 0 0 0 0 0 0 4 10 0 13 9 0 27 0 6 0 5 0 0 29 0 0
17 8 1 1 9 0 0 32 22 17 0 0 18 1 0 8 1 14 14 0 0 2 2 0 0 0 1 0 0 23 21 30 0 21 25 4 15 25 10 0 11 2
0 62 0 0 14 24 0 15 20 0 0 30 3 20 4 0 3 24 17 0 0 11 2 6 0 0 26 0 20 19 0 1 0 0 0 0 8 0 37 44 27 6
0 1 8 0 4 0 9 30 0 0 0 1 2 8 0 9 0 0 22 27 0 0 0 0 6 0 0 0 8 5 0 4 0 0 15 0 7 26 0 0 22 22
31 3 0 0 16 6 13 17 0 35 0 6 0 12 0 6 0 0 5 2 16 36 1 14 32 0 0 0 2 0 19 47 7 12 4 9 1 0 21 7 0 32
4 4 15 0 49 7 23 19 0 0 0 0 2 0 7 2 1 12 12 0 0 19 15 0 0 1 18 2 0 6 0 6 2 0 17 3 0 6 0 35 0 9
1 37 32 0 40 0 5 35 9 23 7 0 0 2 0 9 17 16 5 11 0 0 6 6 0 5 13 0 12 33 24 5 23 0 0 0 7 0 31 34 39 10
0 23 46 6 0 10 0 0 0 10 0 0 6 27 9 6 25 12 10 5 0 0 0 0 5 14 0 0 11 0 12 14 4 0 0 0 0 0 6 1 16 64
0 21 0 70 30 20 4 20 16 0 27 5 0 6 6 5 11 0 0 0 20 23 10 6 4 1 8 0 0 7 25 0 29 32 32 4 0 10 7 0 0 0
0 12 35 1 0 0 0 21 0 11 10 0 0 3 38 0 0 0 10 12 2 0 10 16 0 2 1 7 21 0 0 17 29 10 0 16 0 40 0 16 0 0
28 14 0 0 0 29 10 7 0 0 4 0 0 1 0 0 0 2 0 0 3 5 9 0 0 0 0 10 10 0 0 0 0 0 2 0 0 1 0 0 35 0
0 37 25 0 8 0 0 0 8 13 0 19 6 20 4 3 0 3 6 4 18 27 14 12 5 0 7 0 0 2 14 2 5 26 0 1 4 26 18 0 0 0
0 0 1 38 0 0 10 1 0 0 0 7 0 14 0 6 0 7 0 18 17 4 0 14 15 16 15 22 1 4 14 0 6 3 15 7 0 31 8 0 2 37
0 5 11 3 27 0 0 19 0 0 0 10 4 3 0 11 3 0 0 15 13 8 26 4 16 21 0 0 3 13 11 9 19 0 0 31 10 15 1 14 0 27
0 0 0 6 31 32 35 0 0 26 4 15 13 0 0 3 0 0 0 1 1 0 0 0 0 12 15 0 0 0 15 25 2 0 2 24 31 43 0 0 0 0
0 16 0 30 3 0 2 0 2 0 4 10 0 0 0 0 0 7 0 0 9 0 0 0 0 0 0 19 0 0 18 27 0 30 30 0 0 20 0 0 0 0
0 5 0 12 25 48 29 11 50 0 0 17 19 10 10 17 0 6 19 11 16 0 20 2 13 0 27 3 16 15 15 19 11 35 1 41 0 9 30 34 25 13
0 10 0 0 25 10 15 16 2 17 8 37 11 18 0 26 0 27 0 20 9 12 0 5 16 0 11 16 0 2 0 3 4 35 1 5 5 11 0 2 5 24
0 18 0 0 0 4 1 6 1 0 0 0 0 9 0 15 2 3 10 6 0 9 0 19 23 0 0 0 0 0 29 0 0 0 0 0 16 0 10 0 30 11
0 15 0 51 0 14 4 20 7 0 18 26 23 0 27 16 37 4 0 11 0 19 25 0 6 12 16 12 12 21 23 0 18 20 0 0 0 8 0 0 13 19
