46 26
38 0 0 5 32 0 22 20 32 0 0 0 0 0 0 0 8 0 0 0 14 0 0 0 0 0 4 18 22 0 0 11 0 0 0 21 32 0 9 0 7 0 0 0 10 25
8 17 2 17 28 18 0 0 12 0 0 0 45 0 20 0 4 0 25 0 9 7 0 61 0 4 8 0 7 0 0 0 38 0 0 0 0 0 0 28 17 4 0 31 2 4
0 0 0 2 0 18 16 4 9 0 0 13 0 20 0 18 0 0 47 0 13 11 0 11 0 0 0 10 10 0 17 0 10 20 0 0 0 0 0 14 0 7 0 0 26 34
0 11 0 0 0 0 40 0 3 0 0 0 3 0 12 23 0 16 12 0 34 9 0 17 0 10 12 9 0 20 3 0 0 0 19 20 1 3 0 0 6 0 0 0 18 0
15 0 14 67 9 0 0 0 0 17 0 13 0 46 7 27 15 0 0 0 8 7 0 14 13 7 21 13 25 9 5 6 3 0 0 0 28 14 6 0 16 0 32 32 12 0
0 0 0 55 0 0 3 15 6 39 0 38 24 11 0 9 4 5 0 0 7 0 6 0 0 23 6 0 0 11 0 13 0 43 8 11 26 59 36 2 0 15 11 0 35 42
29 182 21 17 1 0 19 0 1 0 9 10 30 42 6 0 11 6 15 0 8 19 0 13 18 13 19 11 0 34 0 15 3 0 27 4 0 46 0 25 26 0 70 3 43 18
6 0 10 34 19 0 37 0 0 11 0 28 13 0 0 3 0 0 0 11 16 10 0 4 0 8 0 0 11 0 6 8 5 0 38 0 8 0 2 12 24 11 0 0 4 0
0 9 33 0 0 38 0 0 2 0 23 27 14 1 3 0 21 0 0 0 7 0 0 0 0 0 17 0 0 0 5 0 3 0 0 30 0 27 27 0 0 0 0 11 0 0
24 41 0 39 0 21 18 0 0 18 13 13 18 0 0 2 19 11 3 0 0 11 0 0 42 0 52 0 0 15 2 2 0 16 1 12 15 1 7 6 4 11 7 0 4 6
3 0 0 3 38 23 38 31 30 36 7 27 18 0 0 23 0 2 0 25 4 0 0 0 9 1 0 26 36 16 31 7 3 0 2 5 5 2 31 33 5 13 5 0 55 40
10 0 0 55 0 0 0 0 25 0 15 0 5 0 18 0 0 14 0 0 0 0 0 9 0 1 7 32 0 26 0 0 29 0 3 9 0 3 9 4 0 0 6 0 9 31
0 13 6 0 74 39 0 4 35 9 3 3 4 0 11 7 0 26 22 0 6 9 5 10 0 11 0 12 10 3 0 13 9 2 7 0 16 2 0 3 7 0 0 9 75 41
45 0 0 0 9 0 0 28 0 4 0 0 0 17 0 1 5 0 2 31 12 0 6 12 17 2 0 11 0 0 5 12 0 17 0 28 7 0 19 23 0 19 7 0 2 45
0 15 0 0 0 0 0 0 14 0 0 0 0 0 0 30 4 4 0 0 12 0 35 8 0 0 3 0 0 4 0 0 22 9 8 20 0 0 7 0 0 0 10 21 0 9
15 6 5 3 0 0 2 0 0 8 0 21 0 0 13 22 1 8 0 14 10 0 0 13 0 27 0 19 9 6 0 0 25 23 0 0 15 4 5 0 7 2 2 18 17 0
28 44 0 0 0 28 3 0 0 29 5 0 4 12 0 0 0 0 0 0 15 15 0 16 0 0 8 8 28 11 0 0 15 22 8 20 15 0 0 38 0 36 0 0 0 12
29 69 0 0 18 0 40 22 0 17 2 0 8 0 5 0 0 0 21 6 0 29 20 0 22 1 0 21 27 34 10 20 7 0 33 11 14 28 0 27 15 2 29 12 0 0
7 0 34 78 0 22 20 7 33 16 0 33 56 6 6 0 19 0 0 0 9 22 8 14 0 31 33 18 0 0 15 0 11 3 12 29 28 24 0 1 7 38 0 24 33 33
11 42 22 1 0 0 25 3 26 10 0 0 0 0 0 0 0 17 0 14 0 0 0 0 31 0 0 5 0 9 0 25 5 14 13 0 4 0 0 5 4 4 0 1 5 0
0 33 30 26 0 0 5 35 0 13 0 3 0 0 5 8 0 2 0 0 0 0 6 8 0 2 0 0 0 3 0 0 0 13 28 32 31 5 9 5 0 0 0 0 42 20
8 31 20 5 0 5 3 32 2 10 0 28 0 3 0 5 3 0 10 0 18 35 0 7 0 1 33 20 0 0 0 0 18 12 0 21 0 30 17 28 0 0 10 0 17 44
42 6 4 87 14 33 0 3 0 0 0 7 16 0 16 0 8 13 0 0 0 0 18 14 0 6 0 0 14 0 27 34 36 0 3 32 4 0 16 19 11 0 42 18 0 0
6 0 36 1 0 3 0 12 12 0 32 18 0 0 0 25 0 0 0 20 3 14 0 0 0 0 0 23 0 23 11 0 0 25 34 7 18 35 3 19 4 7 5 35 0 0
0 0 0 19 9 1 6 44 24 0 0 0 0 29 11 20 0 17 0 0 0 1 19 15 2 0 2 3 0 4 17 0 2 14 63 0 0 5 14 0 25 0 32 0 0 31
0 13 0 33 0 12 15 0 0 0 0 0 0 0 0 0 0 10 32 0 0 18 0 0 8 0 8 0 0 0 0 0 30 11 0 0 53 0 6 1 0 18 24 0 0 0
