42 24
20 7 20 0 29 11 0 0 23 0 23 0 12 13 0 19 20 15 4 31 3 13 4 30 1 0 0 8 0 27 7 0 0 15 13 2 7 0 3 44 6 0
0 0 0 0 0 6 0 0 48 0 48 20 4 0 0 0 3 0 31 4 6 0 23 14 0 10 0 12 6 31 0 14 13 0 2 10 16 10 0 46 0 62
28 0 22 0 11 32 0 0 33 31 2 0 0 9 0 13 15 0 5 12 31 0 22 0 9 17 23 0 45 2 10 2 24 2 6 0 0 34 10 12 18 0
25 0 0 0 11 0 2 20 1 0 0 9 0 0 16 6 2 4 0 1 14 6 0 0 4 25 0 0 41 5 1 5 0 0 8 0 27 0 12 0 0 16
24 0 0 0 25 15 4 19 17 0 49 0 0 21 2 10 2 0 0 0 20 0 0 8 0 2 34 3 0 4 18 13 17 39 19 1 7 29 0 0 12 11
43 3 0 3 17 0 15 6 0 0 0 0 4 9 0 0 27 23 16 0 16 10 0 11 14 25 0 4 0 42 0 11 5 9 1 1 17 0 3 10 23 25
0 0 50 0 16 44 16 7 5 1 6 0 27 25 22 36 1 9 9 0 0 16 0 15 5 28 12 9 3 2 5 37 7 30 0 0 0 2 0 35 6 10
38 0 23 5 0 0 0 33 0 5 20 0 5 0 0 9 1 0 0 0 0 0 0 10 1 25 0 0 0 1 26 0 0 10 0 0 38 0 45 0 0 16
6 15 12 15 41 0 0 17 21 0 0 8 29 3 0 0 0 17 5 36 0 0 15 3 17 1 7 8 12 1 2 29 10 2 4 31 0 10 7 0 0 29
10 0 22 0 6 0 0 11 0 18 17 3 0 0 0 0 0 21 3 1 4 0 7 0 10 0 0 18 13 0 2 0 9 3 24 0 3 0 20 0 0 35
6 26 1 14 0 22 0 2 30 0 24 11 13 0 0 8 0 31 0 14 3 0 0 0 0 0 12 0 0 16 0 0 0 14 15 7 0 0 30 13 0 11
50 0 0 0 26 0 16 6 7 7 30 25 6 15 14 26 2 0 28 0 0 7 36 0 0 0 0 6 28 13 22 0 7 6 0 0 32 24 0 1 52 15
8 0 0 28 0 0 21 0 13 0 3 44 2 0 0 15 21 0 0 15 0 20 0 0 21 0 11 0 8 17 24 8 0 0 13 0 0 15 32 8 8 30
8 0 14 0 7 10 22 0 4 0 8 0 0 33 8 10 0 7 0 2 7 0 6 10 0 0 0 0 26 11 0 0 0 10 17 0 0 2 0 0 0 0
0 40 0 11 0 36 8 0 7 0 0 17 10 0 11 29 5 3 0 1 8 4 4 0 3 8 0 15 18 10 7 0 9 6 2 0 0 19 4 0 0 15
2 37 2 0 0 0 34 0 21 21 0 0 0 9 6 7 1 15 0 2 0 11 6 17 8 3 3 2 3 34 14 12 0 0 0 6 0 2 32 0 34 0
0 26 0 23 0 23 0 4 5 0 0 28 15 13 5 16 11 5 10 16 0 6 12 4 0 0 4 40 0 4 8 11 5 6 29 26 8 4 0 19 0 5
0 0 12 0 16 1 32 6 13 4 0 1 6 2 20 15 14 10 5 0 4 1 4 17 0 0 15 2 0 8 15 0 14 0 2 7 1 23 29 0 0 0
0 16 16 0 10 0 0 0 42 4 0 0 13 0 0 0 0 16 15 0 4 3 0 0 0 13 2 0 7 33 0 0 1 29 0 8 0 10 15 0 0 6
0 0 2 0 10 15 5 0 2 0 0 19 1 3 10 0 5 0 0 0 5 4 0 0 25 0 0 0 3 12 5 0 0 0 4 0 0 0 0 15 0 34
28 0 20 2 25 1 2 0 5 9 11 11 0 23 0 3 13 10 19 8 17 0 0 5 0 1 0 14 17 5 0 27 14 0 13 0 26 8 5 0 0 0
0 9 12 0 0 1 15 0 17 8 0 0 0 0 14 0 0 0 0 0 0 33 11 0 2 36 11 14 6 14 0 10 2 7 1 0 0 11 9 0 0 26
0 6 30 20 23 0 4 0 14 0 17 13 9 14 16 0 0 0 19 3 15 10 20 20 11 1 2 15 11 12 0 0 30 0 0 17 0 21 0 17 0 15
0 0 0 0 0 7 1 39 0 3 0 20 13 0 0 24 10 0 0 15 21 0 0 0 0 13 0 0 0 0 0 20 0 0 11 0 0 0 13 11 0 0
