46 26
0 2 19 6 0 39 18 0 25 0 0 1 0 5 3 0 25 3 33 0 36 10 7 0 18 0 0 15 0 24 0 0 0 0 11 4 0 5 0 35 0 4 0 0 26 38
0 3 0 0 0 0 31 37 20 0 32 0 29 0 0 0 20 41 23 0 16 14 0 7 0 0 18 0 1 0 5 0 0 0 0 31 19 15 0 0 30 45 18 33 58 1
11 2 23 10 0 0 27 3 0 0 9 11 0 0 0 0 10 0 0 21 2 0 16 0 6 0 0 5 0 4 19 0 5 51 4 0 20 13 0 22 16 0 0 0 22 5
0 25 0 22 36 0 0 2 0 0 49 0 21 0 0 23 0 21 0 20 0 0 0 0 0 3 25 0 0 1 5 0 0 36 0 0 26 17 9 1 37 13 0 24 0 0
0 27 2 5 0 0 27 0 6 6 0 4 0 15 12 0 0 0 0 14 7 0 21 0 8 3 11 0 1 1 5 0 17 27 0 31 0 0 39 3 5 11 0 11 0 16
0 5 34 3 0 10 0 17 42 35 3 0 18 7 0 0 0 0 14 13 6 6 12 5 12 0 3 0 18 8 0 0 0 21 28 0 46 3 3 31 0 50 0 12 0 24
7 45 45 0 40 34 0 20 6 0 0 13 6 1 26 11 0 17 15 1 15 4 21 11 13 29 16 0 11 40 12 0 0 41 2 21 0 8 0 9 11 0 2 16 0 5
20 3 8 40 0 29 0 0 0 6 37 0 0 12 0 0 0 34 5 1 20 14 25 1 6 1 0 0 3 6 0 21 1 5 55 14 0 20 0 0 37 0 0 0 9 2
25 7 50 77 0 36 1 2 0 32 6 22 29 15 13 0 0 0 0 0 0 2 7 15 15 11 23 13 1 0 20 0 0 0 0 0 11 8 26 11 49 1 37 0 0 50
38 3 17 7 0 6 21 41 18 1 37 0 3 24 1 0 26 17 10 0 0 0 19 0 0 0 0 3 0 11 0 0 4 9 0 3 23 4 28 0 13 15 9 0 0 16
0 6 8 0 0 0 5 11 21 13 30 0 29 0 0 6 0 0 0 0 0 0 22 6 7 16 0 20 13 31 0 0 0 1 0 0 0 0 6 6 46 12 0 0 0 16
29 84 0 8 0 0 26 3 5 0 1 0 22 0 0 0 30 7 0 0 1 20 17 0 0 24 0 0 0 20 0 9 0 7 0 23 26 7 0 7 66 31 36 7 15 0
0 0 20 1 17 0 0 0 7 0 0 0 10 0 4 10 2 0 5 5 18 7 0 0 0 10 0 2 0 0 0 0 0 24 7 0 7 0 0 0 10 7 0 7 0 0
7 13 0 0 0 31 23 0 11 6 3 0 18 17 0 47 0 1 31 15 27 16 14 14 9 14 0 0 0 38 4 9 0 6 0 0 26 0 14 14 9 2 27 0 0 25
38 0 5 0 0 0 0 3 9 0 3 6 17 3 1 4 0 9 11 8 0 0 0 6 5 8 0 7 0 17 0 31 25 0 0 9 0 5 0 0 3 0 0 0 3 0
0 23 33 1 9 20 5 0 3 4 34 0 0 27 5 0 15 0 0 9 0 0 13 0 0 0 11 15 0 6 0 17 0 0 15 8 1 6 0 0 0 3 5 41 37 0
41 1 34 0 11 23 5 0 2 25 0 0 0 0 5 24 0 12 0 0 16 12 13 13 18 5 45 0 58 12 28 11 9 25 11 0 13 0 32 0 12 12 26 0 7 30
22 0 6 0 17 9 0 0 2 10 8 28 0 0 9 1 0 0 0 21 31 24 37 11 0 25 0 0 12 8 26 0 0 15 7 5 25 0 32 31 0 16 42 0 0 23
0 0 8 43 0 0 3 0 20 0 5 0 5 17 1 0 0 0 0 4 1 0 0 0 0 0 7 0 11 5 17 0 0 2 14 0 2 15 0 5 0 42 0 0 5 0
24 12 14 6 0 0 75 18 29 2 0 3 44 4 1 2 4 0 0 4 57 0 29 11 4 0 5 0 0 0 0 13 0 1 8 6 1 0 6 0 21 26 35 37 1 0
15 0 20 2 0 0 33 0 0 27 42 0 0 0 0 0 2 19 13 0 0 21 2 0 0 0 0 0 4 0 0 0 19 11 0 0 1 0 0 0 24 35 31 0 0 35
7 0 40 0 0 0 1 23 10 0 0 0 0 0 6 9 0 14 0 0 11 4 2 0 16 0 0 0 0 17 0 0 0 0 0 20 0 0 0 0 0 0 46 0 0 0
13 0 0 0 0 0 40 1 45 0 0 19 0 0 6 0 8 4 0 13 14 0 6 9 0 15 0 0 6 0 19 0 2 0 2 34 0 21 0 0 57 11 0 51 27 0
15 0 36 0 23 0 0 0 0 15 0 0 3 11 0 15 0 22 0 0 0 8 0 12 17 0 0 26 18 0 2 0 2 0 0 0 0 14 55 0 0 30 0 0 0 0
60 0 36 0 0 0 0 8 0 40 20 0 0 10 30 8 0 21 42 6 17 12 22 0 0 0 16 0 0 0 16 0 11 12 9 0 0 0 20 3 0 2 8 12 36 36
0 0 8 6 0 28 29 20 0 0 24 32 2 0 0 0 0 0 11 14 0 0 0 0 0 15 11 4 0 0 46 4 0 59 42 29 24 11 0 0 15 15 0 19 25 16
