46 26
0 0 0 5 0 0 16 0 10 29 30 9 0 0 0 2 16 9 12 41 9 3 4 0 9 0 0 0 0 0 0 12 41 0 15 0 0 18 34 5 30 0 34 0 21 0
7 7 19 30 1 0 12 2 20 35 0 16 0 0 9 0 28 1 1 12 0 0 15 34 23 0 0 16 0 15 0 13 0 30 10 0 0 23 0 0 21 5 0 24 2 20
1 76 0 10 12 15 29 9 8 0 22 0 28 0 0 2 13 3 7 26 18 0 15 0 0 0 0 0 0 3 25 31 29 3 3 76 4 4 0 0 34 1 0 0 43 0
0 58 2 32 2 0 0 0 0 0 8 0 0 0 0 11 0 13 3 0 0 0 8 0 0 0 24 1 19 0 14 47 0 0 0 26 0 0 0 5 9 5 0 12 1 15
0 0 38 0 0 0 0 0 0 11 5 15 0 0 15 5 0 0 0 9 8 0 0 0 0 6 16 0 9 0 23 6 0 0 0 0 0 7 17 0 53 18 12 0 0 0
0 0 0 21 0 35 3 30 0 4 0 0 14 19 0 11 9 4 11 0 1 3 0 0 8 0 34 15 0 16 0 10 0 40 0 0 3 0 5 0 17 13 17 19 1 18
15 0 0 6 0 0 0 21 0 24 0 20 44 6 5 14 0 0 0 11 4 0 23 0 7 0 11 30 21 0 0 23 0 0 0 0 0 9 0 8 0 24 20 0 20 14
46 0 17 0 0 24 0 0 27 10 0 0 28 0 0 15 0 0 0 2 7 1 0 15 0 0 26 1 9 18 3 0 0 11 0 39 6 18 0 0 0 0 0 0 32 1
7 0 0 7 65 20 11 0 12 2 23 0 0 0 0 0 0 16 0 8 16 1 5 17 0 41 0 18 5 2 0 0 9 23 16 0 32 0 0 0 13 11 19 0 0 17
0 9 27 52 0 20 37 11 0 6 9 8 1 22 0 0 0 5 16 0 4 8 0 0 4 28 0 0 10 16 1 7 0 2 14 28 0 0 0 0 0 38 0 0 0 0
39 8 0 14 0 2 33 0 8 2 12 0 20 30 21 0 2 14 17 3 3 1 3 0 0 0 0 7 0 19 0 57 0 16 0 6 0 0 0 80 11 0 0 30 0 1
0 0 0 46 0 30 0 2 0 7 10 0 4 28 26 0 16 0 2 0 0 0 0 0 11 3 13 0 14 0 3 5 5 29 0 12 0 0 7 21 4 0 14 0 30 10
0 18 0 3 8 23 0 0 0 0 0 0 8 1 5 0 19 4 0 22 0 1 0 21 11 0 0 0 15 16 10 0 0 1 13 0 0 6 21 0 9 0 25 0 0 0
0 0 37 0 0 0 5 0 0 0 0 0 0 24 0 24 19 0 3 12 7 1 0 17 0 0 12 7 6 10 0 0 3 3 0 19 0 29 0 61 0 0 0 0 0 0
0 0 0 10 0 27 0 13 4 23 40 0 2 0 20 0 26 5 20 9 4 0 9 0 13 6 13 0 21 20 3 1 23 25 29 2 4 7 1 64 18 6 8 7 0 0
37 18 0 7 0 0 0 27 32 41 19 33 0 0 2 22 16 0 4 0 1 19 10 22 19 0 13 0 3 0 12 24 22 7 26 13 35 62 1 12 22 0 0 53 55 0
8 0 0 27 0 29 46 0 0 0 18 48 1 7 28 56 2 13 1 0 4 2 0 38 5 0 10 9 24 7 10 31 18 7 20 20 1 20 15 0 0 8 47 0 6 6
5 0 0 49 0 0 7 0 0 0 0 0 9 0 0 0 19 0 0 18 0 0 0 25 0 0 0 7 0 0 15 0 0 0 0 51 0 19 5 0 0 0 0 0 0 36
0 6 0 31 14 4 0 27 20 25 18 3 0 18 0 0 9 0 12 0 0 8 2 0 13 7 0 11 28 0 0 23 23 0 23 5 0 21 11 0 5 13 13 0 0 6
24 23 2 24 0 12 0 2 7 0 0 0 2 5 25 0 0 12 0 0 20 14 7 18 8 0 4 28 8 15 0 10 34 5 0 0 8 2 7 2 27 9 0 0 23 30
65 44 51 0 12 11 0 0 0 36 20 1 0 0 3 0 8 0 4 5 0 19 0 3 26 5 0 0 0 15 15 0 1 0 32 35 5 10 0 0 6 4 0 0 4 25
45 0 1 1 0 0 0 2 0 0 0 1 13 10 0 0 0 13 0 0 14 0 14 0 13 0 6 17 15 5 4 0 16 0 0 0 5 2 17 0 0 0 3 58 17 20
5 36 0 12 2 0 2 8 0 0 26 27 0 6 4 14 22 0 11 8 17 0 0 28 16 0 19 13 0 6 19 0 0 8 0 2 0 38 17 0 33 32 0 23 0 0
0 0 0 0 0 18 15 0 0 1 45 0 0 23 0 0 17 9 0 0 19 0 0 0 0 24 38 0 0 4 0 18 0 17 2 36 2 24 0 29 0 0 7 0 0 12
17 14 16 10 0 1 7 0 0 29 47 27 11 29 0 5 30 18 16 0 21 18 1 15 10 0 10 0 5 10 8 0 6 19 16 0 26 68 0 18 25 25 10 19 0 19
0 0 11 8 0 1 51 26 0 0 31 0 0 11 0 25 0 4 0 6 20 0 4 0 5 6 55 8 0 0 6 0 7 0 2 0 7 49 2 20 5 35 25 0 19 0
