46 26
0 0 0 69 12 0 0 0 28 0 15 26 0 17 68 22 0 0 22 16 11 0 0 0 30 0 0 0 4 19 17 17 8 4 0 0 5 31 0 0 30 0 44 6 0 0
4 0 29 0 6 0 26 0 3 37 10 0 19 0 18 0 0 13 4 12 0 5 40 0 15 0 5 12 0 2 11 1 5 10 0 0 0 0 1 0 0 0 0 5 0 0
23 8 22 0 10 38 21 36 34 0 0 0 0 0 23 0 6 18 2 0 0 0 0 6 13 0 0 20 0 21 0 0 0 6 0 0 12 8 9 21 0 16 35 2 34 0
1 36 0 102 29 1 22 17 13 12 27 0 37 0 4 0 8 14 12 22 21 0 0 34 1 4 18 42 18 2 4 0 0 15 30 22 0 29 0 22 56 4 11 11 79 0
0 0 8 0 1 40 0 0 17 17 8 0 0 17 0 0 0 0 0 0 22 0 23 0 0 9 0 0 5 0 0 0 0 0 9 0 8 0 2 0 0 13 20 0 35 7
5 0 25 20 14 8 0 0 0 0 0 0 0 2 0 0 15 0 8 0 0 0 0 0 0 0 9 25 0 0 0 0 0 1 5 0 0 0 0 0 15 0 0 0 0 14
24 0 9 32 0 0 29 1 0 0 0 0 0 0 19 0 19 0 0 0 13 0 4 3 0 15 4 0 17 23 12 6 0 6 22 31 7 0 38 0 6 0 2 7 9 0
8 42 6 0 0 13 0 0 14 0 0 1 0 0 50 0 1 0 4 0 0 0 0 0 0 0 4 0 0 0 0 12 0 4 0 1 0 0 10 0 0 7 11 54 0 31
1 53 0 0 0 0 0 10 0 0 35 1 7 0 0 0 21 10 0 26 0 0 0 34 0 5 25 0 0 0 5 14 0 0 6 0 1 8 15 0 0 0 27 0 0 67
12 0 0 0 3 2 0 3 0 21 7 1 1 0 0 0 15 20 0 11 12 10 21 22 1 0 13 0 0 0 10 6 2 11 0 0 0 20 5 4 0 0 13 0 2 22
28 8 0 32 0 0 5 0 0 0 35 0 7 0 0 0 5 0 0 40 5 0 0 0 19 5 0 7 4 0 2 19 0 5 5 34 14 2 26 0 21 0 0 0 0 17
11 62 0 0 0 13 35 15 0 0 53 19 8 7 2 0 3 0 28 0 14 0 0 10 8 19 26 7 0 17 9 10 0 11 0 34 9 33 18 29 10 0 0 23 28 27
0 1 32 0 1 25 10 0 11 0 17 0 8 0 5 0 10 20 0 9 16 1 4 0 2 0 4 0 0 0 41 10 0 3 0 2 31 53 0 0 11 12 0 9 9 0
36 0 60 0 10 10 4 9 44 0 11 2 0 0 0 0 0 0 0 0 11 24 14 10 0 0 0 14 26 0 4 0 7 0 0 0 12 0 7 12 0 0 0 7 0 24
0 0 11 0 37 5 0 0 0 0 31 0 11 11 27 2 9 25 0 14 2 0 18 0 50 0 0 0 0 0 26 0 0 12 0 0 0 8 28 4 12 3 33 18 0 15
0 0 8 0 13 0 39 0 4 12 2 0 43 10 17 0 0 44 22 9 0 3 0 5 0 0 6 0 0 10 9 0 0 0 17 0 55 25 0 1 34 0 3 0 16 31
5 26 17 43 11 0 9 0 18 0 7 23 0 0 0 22 9 0 16 11 5 1 0 2 3 3 10 40 12 14 1 0 15 0 23 0 5 22 0 39 0 21 16 14 0 0
12 15 32 0 0 12 0 14 11 11 0 0 26 8 0 28 10 0 0 0 0 0 2 0 6 0 0 0 0 13 0 0 0 17 32 0 0 23 14 0 0 0 0 0 0 0
0 5 13 0 0 0 31 0 23 0 18 0 9 2 0 13 14 15 11 0 0 9 13 6 21 0 5 7 18 11 2 28 14 0 5 0 12 0 0 33 0 21 11 0 16 0
11 23 63 30 39 0 15 8 25 15 5 3 36 12 19 0 0 23 13 0 16 32 20 4 9 0 17 36 10 0 10 5 25 11 3 2 24 2 43 5 45 34 0 0 15 5
0 0 13 9 10 13 14 10 0 0 8 0 37 24 39 3 5 16 0 0 0 0 0 25 0 10 14 7 0 23 18 0 7 0 20 0 8 17 0 26 19 0 0 31 0 0
0 0 35 0 0 0 8 44 1 0 9 0 30 18 6 0 0 9 3 0 0 3 0 7 11 31 37 0 6 0 9 7 0 18 33 0 6 36 0 0 0 0 31 36 19 0
27 0 22 0 29 11 58 9 34 18 21 0 6 0 30 22 16 8 6 21 0 0 0 0 28 1 22 10 0 16 15 21 0 0 0 0 0 36 0 0 40 4 33 0 0 24
0 43 0 0 8 0 25 14 76 22 0 0 26 0 0 0 25 0 0 0 0 5 11 0 0 4 12 12 17 1 8 4 0 11 26 0 22 12 20 17 2 25 0 16 15 37
46 17 42 0 2 21 21 5 0 0 0 0 15 0 14 15 75 0 16 15 14 0 6 0 24 0 10 0 1 0 0 18 0 0 21 0 60 0 5 9 4 0 42 43 1 20
43 0 0 4 41 0 16 8 27 5 24 20 0 14 17 11 9 0 0 24 8 0 14 2 37 13 13 54 0 31 0 20 2 23 14 22 2 1 1 17 0 0 16 54 0 21
