40 23
0 19 0 19 0 0 0 0 0 0 0 26 0 0 0 12 0 0 0 0 19 0 0 0 13 0 0 0 0 0 0 0 0 15 0 6 0 39 0 0
4 17 13 20 34 0 14 15 0 0 0 17 12 0 19 0 18 13 17 6 0 0 0 11 0 7 12 0 14 2 4 0 3 17 20 2 0 2 0 15
24 11 0 0 26 6 30 0 8 0 16 21 0 0 0 11 15 6 12 11 3 0 15 9 0 21 25 3 0 13 0 8 7 17 34 0 22 0 0 10
0 32 5 0 0 3 26 0 0 17 0 0 0 0 7 38 2 0 0 18 0 0 0 0 1 9 0 0 0 10 18 11 26 15 0 0 1 0 0 24
8 12 3 0 17 28 43 3 40 0 21 4 12 14 0 7 0 11 0 0 5 26 17 7 5 0 3 4 17 0 0 21 3 11 0 45 30 4 0 16
27 0 25 0 16 0 3 0 30 0 0 3 5 24 0 13 3 24 1 14 16 12 17 7 0 0 0 45 0 0 0 0 0 0 0 0 0 24 30 17
49 0 0 0 0 0 0 26 8 3 2 0 16 0 0 0 0 6 31 0 0 16 0 5 10 24 11 0 3 25 2 8 0 2 16 22 11 11 0 24
32 15 0 14 0 22 64 0 11 27 6 5 26 0 0 9 18 27 37 6 3 8 4 4 13 0 3 22 0 15 29 8 0 0 13 17 30 31 41 24
0 0 15 0 0 27 3 0 0 0 8 0 1 1 11 10 0 15 0 1 0 0 14 2 0 6 0 0 0 0 0 8 0 8 0 0 0 2 33 0
0 30 0 22 14 0 7 5 0 5 0 0 2 0 0 0 0 5 14 7 0 0 0 1 11 33 0 0 0 5 0 30 0 0 0 0 0 0 0 0
6 9 6 20 13 40 5 0 8 8 0 17 4 14 16 0 8 2 17 0 2 0 14 10 13 2 3 43 0 18 3 0 0 0 33 24 31 0 18 0
27 23 0 5 0 6 0 39 5 40 0 2 10 0 10 3 16 2 6 8 0 0 18 0 23 16 0 35 6 0 7 19 2 0 0 30 0 43 0 4
0 23 0 5 71 9 31 30 0 15 0 6 10 11 11 11 0 6 0 0 5 0 0 7 25 6 2 18 14 0 0 0 3 9 20 31 25 61 0 0
20 14 28 0 0 0 8 0 0 4 19 2 16 11 13 11 0 4 0 9 0 9 0 0 7 19 1 18 25 0 0 0 26 5 0 38 0 0 3 27
1 0 0 5 0 0 18 0 8 26 0 1 4 0 0 3 0 18 18 0 0 0 11 0 18 7 2 0 7 25 0 17 0 11 6 3 0 0 0 0
59 11 0 20 23 18 20 8 0 16 2 25 0 7 21 8 8 27 19 0 0 13 2 29 25 25 0 25 15 18 2 17 26 15 30 34 25 12 0 18
0 0 0 11 16 0 26 6 5 30 0 0 9 0 0 0 0 21 2 0 16 8 6 0 38 0 2 0 3 8 6 25 7 0 2 2 0 0 0 23
35 0 55 5 31 42 8 24 2 23 19 18 18 0 4 38 0 0 12 0 13 2 35 20 26 14 35 2 0 2 11 7 53 16 19 7 27 11 3 5
0 19 0 2 0 34 0 26 14 0 8 4 0 0 0 13 7 0 0 5 19 16 0 7 14 7 18 5 7 11 0 3 25 5 16 7 0 28 11 0
20 0 2 21 10 0 0 13 0 0 24 0 0 0 10 2 0 21 0 0 0 0 0 0 0 2 0 0 0 0 0 0 0 10 0 0 7 8 7 0
7 0 23 3 0 5 32 4 0 6 14 16 0 8 1 3 0 33 19 3 11 4 7 0 32 31 0 25 11 0 0 0 7 0 7 10 0 0 53 14
18 0 17 21 28 0 31 1 15 5 0 9 0 0 14 0 0 0 15 7 0 3 6 5 15 0 0 0 4 20 44 0 32 16 0 29 0 0 0 0
38 0 3 0 22 0 5 11 4 0 21 3 0 7 25 0 0 6 0 0 0 16 38 4 10 0 0 18 0 0 0 21 0 0 0 18 0 0 23 0
