46 26
9 57 0 32 40 23 0 18 0 0 0 0 0 0 24 0 2 19 32 9 0 0 8 10 15 0 0 0 32 0 0 13 4 37 6 0 10 22 13 13 4 2 0 39 45 0
0 0 7 0 15 0 16 3 6 21 8 0 22 4 8 67 0 27 12 0 43 12 11 0 0 0 22 35 0 14 3 0 11 0 12 9 21 0 0 19 0 21 18 5 7 0
0 0 0 30 9 18 3 13 0 0 4 11 0 19 0 13 0 23 0 0 0 0 8 3 0 0 0 0 0 17 8 0 6 0 2 0 0 0 2 0 38 0 8 40 4 0
0 0 0 0 3 0 0 0 0 0 10 17 0 0 0 17 0 0 0 12 0 0 2 0 0 0 19 0 0 0 0 1 0 0 0 0 0 4 6 0 0 0 0 4 0 6
0 14 0 0 0 2 0 0 31 0 3 0 19 4 17 12 4 4 0 11 0 19 0 21 16 0 17 0 0 0 20 19 4 19 0 0 18 0 0 31 5 6 0 17 12 5
1 0 0 29 41 0 35 13 30 0 0 7 16 0 20 1 0 0 8 12 0 0 0 24 31 1 8 0 0 5 4 20 45 5 18 0 17 33 0 15 5 0 0 0 38 39
4 29 0 33 29 9 49 34 15 4 5 0 0 6 1 4 11 0 12 11 29 3 23 9 3 1 0 4 2 3 46 5 27 27 25 0 27 8 0 0 53 0 0 0 15 5
8 36 2 0 0 0 3 0 0 0 0 7 0 0 0 0 0 0 25 0 0 0 8 0 0 0 0 0 9 0 0 14 0 0 2 0 8 36 0 0 0 0 0 22 8 1
0 0 0 0 0 0 38 0 28 0 0 0 22 0 0 25 6 0 0 0 0 0 2 0 7 0 11 0 0 1 0 0 0 0 22 1 25 13 32 4 4 4 0 0 6 5
8 0 2 9 5 3 0 6 0 0 0 2 12 24 0 0 25 5 0 23 0 8 25 0 8 17 2 0 5 22 5 0 21 3 7 4 43 11 6 0 0 27 2 5 9 15
0 0 0 1 39 28 17 6 0 0 0 0 0 9 0 0 0 27 24 0 15 15 0 21 0 0 0 15 10 0 0 0 0 3 3 10 6 0 9 3 2 0 17 30 48 0
1 8 5 1 0 0 13 0 0 0 0 12 6 31 5 0 1 0 1 35 0 0 0 0 23 9 0 12 0 6 0 0 0 13 12 0 2 14 1 1 0 22 0 14 41 0
40 27 1 16 0 3 23 3 8 22 6 30 0 0 0 8 12 0 0 15 0 5 12 8 0 21 3 0 39 25 1 22 9 0 0 12 18 0 13 32 38 13 2 5 2 0
125 0 32 0 0 36 0 4 8 10 0 9 7 8 2 23 16 0 23 1 0 33 0 0 0 0 13 0 0 0 0 0 0 3 44 0 8 6 61 24 0 28 0 39 18 6
47 18 13 7 4 9 0 0 0 1 11 1 0 13 9 8 0 3 22 10 19 0 0 0 5 0 0 12 6 0 0 10 13 0 0 0 1 14 37 12 0 0 5 2 51 11
4 9 0 0 7 0 0 19 0 2 9 0 0 2 9 15 21 17 0 12 24 15 0 5 0 0 0 4 0 0 0 13 11 0 0 0 19 21 4 0 15 5 0 21 29 0
0 5 0 52 0 0 37 6 0 6 33 0 0 0 0 34 0 0 5 0 0 0 10 0 0 0 12 0 0 0 27 5 11 0 0 0 20 22 0 0 0 3 0 87 0 0
0 0 0 0 0 0 7 1 0 0 0 0 41 0 11 0 0 1 3 15 0 8 5 0 0 11 0 0 0 0 0 0 2 0 27 0 0 5 0 6 0 29 0 12 4 0
37 2 30 0 3 0 27 54 0 4 0 0 0 4 12 21 0 1 0 22 0 0 21 13 0 12 1 0 18 0 0 31 30 0 12 0 15 23 0 1 40 8 0 0 8 1
0 0 0 13 28 39 40 0 14 0 13 13 0 0 0 0 13 4 1 3 0 12 0 0 18 0 11 0 6 25 14 14 43 0 13 27 0 13 4 26 12 3 28 0 27 0
32 0 0 0 52 0 12 11 24 3 27 39 7 13 0 14 0 6 15 15 0 7 0 1 0 9 0 5 27 0 17 17 36 6 0 10 0 7 11 0 0 13 0 0 33 6
28 30 0 64 0 9 0 35 2 0 0 8 5 15 20 31 0 25 20 0 5 2 0 0 13 0 9 24 27 13 0 47 0 2 0 18 19 10 28 0 26 22 29 0 49 0
41 1 42 6 21 5 4 30 16 21 22 44 0 19 16 0 5 24 13 25 6 34 0 0 0 10 14 4 22 0 0 8 7 19 25 0 0 13 0 28 44 20 12 23 44 24
0 26 0 0 7 8 1 12 25 3 25 2 23 0 19 0 0 0 22 29 0 0 25 0 22 0 33 2 0 15 0 23 0 31 15 0 7 13 2 12 0 0 0 0 34 0
11 5 0 3 0 31 10 9 31 15 0 0 0 20 36 0 0 9 0 8 0 0 33 0 0 0 0 31 19 0 13 0 0 33 0 10 31 2 0 31 0 27 0 8 0 0
0 25 0 0 0 0 37 0 0 12 19 0 0 10 3 0 0 19 0 22 24 0 0 0 17 12 18 15 2 19 0 7 15 16 21 16 0 1 19 1 18 4 5 37 12 0
