46 26
7 43 0 1 0 21 0 26 3 21 33 12 29 12 40 35 0 0 0 44 0 6 3 0 0 24 17 0 13 0 71 0 11 20 9 0 0 0 17 33 0 0 0 65 0 0
44 0 19 0 1 35 0 6 0 0 0 0 22 15 27 23 0 20 1 2 7 0 0 8 1 0 13 17 0 0 14 0 0 17 0 0 12 6 23 13 20 27 0 24 35 0
0 2 0 9 10 0 0 0 21 17 16 0 13 0 0 15 8 0 6 11 5 0 0 0 5 4 0 8 6 55 7 31 0 2 8 0 13 3 11 0 16 0 5 12 0 0
43 0 0 0 0 0 8 3 3 26 18 0 24 6 8 9 0 0 0 4 0 0 19 17 21 20 0 18 0 32 0 19 11 3 0 0 0 0 6 13 17 0 0 21 6 52
0 14 12 0 9 39 9 12 0 14 4 4 17 0 4 13 27 0 14 13 3 25 2 0 0 0 35 0 0 17 0 0 2 0 2 0 0 0 0 13 0 0 0 26 43 40
0 0 41 23 0 73 7 21 6 0 0 33 7 0 6 0 0 0 14 6 13 0 0 0 16 20 0 0 14 0 0 0 11 0 0 0 0 0 0 7 18 0 24 41 6 0
5 13 10 22 0 0 0 17 0 0 3 4 15 12 0 0 4 0 0 0 16 0 6 4 26 0 23 12 6 15 6 15 0 0 0 0 5 0 17 0 2 5 14 0 17 0
32 3 35 0 25 0 29 6 0 12 18 3 0 0 0 7 0 0 8 0 0 40 3 10 0 3 0 0 18 8 0 0 0 6 0 29 15 16 0 1 0 0 3 20 3 2
33 2 14 23 0 59 0 3 23 8 0 44 10 26 0 10 29 8 20 11 1 0 5 19 0 5 0 0 36 9 23 31 0 1 6 9 31 25 26 9 27 11 0 6 0 0
0 0 0 0 0 0 11 0 0 4 0 11 12 0 0 0 0 5 0 0 0 18 2 14 10 0 0 0 8 13 5 2 0 0 0 11 28 0 0 13 0 0 7 1 5 0
0 53 0 0 0 0 0 39 26 0 33 7 0 0 0 0 23 13 11 5 13 3 9 13 2 19 2 4 4 5 2 6 4 13 34 34 41 6 0 9 23 12 0 32 0 7
0 15 15 0 18 0 8 0 30 0 32 48 33 22 23 0 12 10 0 0 0 12 18 7 0 9 15 15 0 0 2 0 2 0 2 0 0 26 27 1 17 0 47 0 0 41
31 44 0 0 0 32 31 10 3 21 0 3 23 0 0 13 0 0 0 0 5 0 8 0 21 0 16 8 3 0 1 12 0 11 0 15 36 5 0 9 0 36 16 12 0 52
35 10 36 11 30 1 22 51 37 13 0 7 2 10 2 0 16 0 22 13 9 19 2 10 9 13 1 0 26 2 23 0 25 2 5 0 10 33 0 6 2 0 0 43 0 56
1 52 3 12 35 0 7 5 0 4 0 0 25 1 0 8 0 0 0 0 0 0 0 0 0 0 0 0 0 6 0 30 31 0 0 0 13 0 0 35 0 0 6 13 0 1
22 38 0 0 26 10 0 0 16 0 0 0 15 8 3 11 0 16 25 0 0 8 20 7 23 5 0 3 24 2 0 0 0 16 7 31 13 37 23 38 7 4 0 25 0 0
43 0 5 13 0 32 0 42 19 8 0 0 16 15 16 20 0 1 8 11 0 5 0 0 8 0 5 25 0 3 21 0 5 16 32 48 0 0 3 0 0 36 7 43 27 0
0 0 0 0 0 26 0 1 0 31 0 0 32 0 26 22 37 0 0 0 0 1 6 1 14 0 10 18 0 24 0 17 0 17 0 11 10 7 0 32 2 3 26 0 35 18
12 8 29 2 14 0 0 1 0 0 56 5 0 0 3 4 0 0 0 7 25 22 0 0 0 6 0 15 0 9 8 23 0 0 0 0 3 10 20 6 0 0 8 22 5 0
0 26 25 15 14 12 5 28 1 45 0 0 29 0 8 5 0 3 18 6 16 0 21 2 10 4 8 8 6 20 0 12 0 0 0 36 5 8 0 0 17 12 22 6 19 10
0 20 14 31 13 0 39 0 16 0 4 10 0 0 0 8 0 11 16 17 8 3 0 0 23 0 0 0 4 5 24 0 0 4 31 0 0 0 0 20 7 2 14 2 11 16
0 2 21 4 0 0 26 0 0 14 3 8 0 0 3 0 13 7 28 0 0 11 2 49 16 0 11 0 0 18 16 0 19 10 0 2 3 13 10 0 0 0 12 12 21 4
34 55 27 0 12 5 34 7 0 18 0 0 1 0 0 0 12 0 0 23 9 0 19 22 11 0 18 6 0 3 0 0 13 0 0 2 0 14 20 0 34 8 0 1 0 44
0 1 22 0 10 47 0 45 0 0 0 34 36 0 7 0 0 0 0 22 0 2 0 0 12 20 6 0 0 0 21 15 2 2 0 71 0 10 0 0 33 15 5 38 39 34
11 13 0 0 5 0 73 0 0 5 30 51 52 0 24 26 3 15 0 24 0 14 0 13 0 0 0 9 24 11 10 0 15 0 0 14 55 26 27 16 54 0 0 0 0 39
14 0 0 0 0 14 0 0 0 14 27 0 0 27 14 29 14 0 0 0 7 0 0 14 0 0 0 18 9 2 0 0 0 6 14 1 0 19 0 6 14 0 0 22 0 65
