46 26
21 61 40 0 21 20 0 1 0 22 6 0 20 0 1 0 22 11 14 0 0 12 0 0 27 0 8 0 1 0 14 0 9 28 11 0 0 36 37 8 0 0 0 41 18 55
28 0 9 0 25 33 0 0 35 0 6 0 0 0 2 18 6 0 15 5 0 0 0 13 31 10 18 0 15 33 0 8 8 0 0 0 0 0 14 22 0 0 18 35 1 23
0 0 0 34 1 4 10 2 0 3 17 20 0 0 7 0 0 23 20 6 5 0 37 0 0 10 0 8 1 6 0 25 17 12 0 25 0 62 16 0 45 19 0 0 0 5
19 34 17 0 0 5 0 12 12 0 0 0 16 0 3 0 10 0 0 38 0 0 0 0 107 0 3 0 43 6 4 8 1 0 21 20 0 14 0 0 0 0 2 31 22 1
0 9 23 0 0 0 0 20 0 28 8 0 12 25 2 5 7 51 0 12 0 24 0 0 18 0 15 0 0 0 20 0 6 5 32 1 0 0 23 0 7 0 0 19 6 11
0 4 24 5 6 1 0 14 3 8 6 3 9 0 1 0 0 16 0 43 15 0 0 16 14 0 9 0 26 1 11 0 0 19 0 1 0 0 31 4 31 0 0 0 0 0
16 0 67 60 0 32 18 10 2 2 19 31 0 16 3 2 1 5 8 4 9 0 22 16 14 26 44 9 8 4 2 0 0 0 11 66 0 55 14 6 0 24 46 15 10 0
21 49 1 0 0 17 0 7 18 3 16 27 0 0 0 6 22 0 0 0 0 21 16 2 14 1 18 0 0 19 0 0 19 0 0 8 7 0 27 0 0 0 19 15 0 0
9 1 4 13 0 2 6 28 0 7 35 10 0 0 34 0 7 0 0 9 1 6 2 4 2 7 0 45 3 0 33 0 8 0 0 10 13 0 0 22 10 21 8 0 0 21
0 14 41 20 0 0 15 0 36 11 0 0 13 0 4 16 1 5 26 13 3 2 29 9 0 1 4 7 9 6 0 0 35 10 23 2 0 29 11 0 0 0 39 49 0 7
0 4 80 17 0 1 0 0 20 20 0 34 5 0 0 0 6 0 0 0 0 0 0 0 0 0 7 0 17 20 0 14 29 0 0 0 0 0 0 37 0 0 0 0 1 8
27 0 0 29 6 1 15 0 42 0 17 9 0 11 5 0 27 18 24 27 17 17 11 0 2 16 9 2 0 0 0 17 0 25 0 11 20 8 0 0 21 0 24 0 0 0
43 0 0 9 0 29 10 5 24 0 23 3 13 4 30 3 18 0 7 0 7 0 12 20 0 10 1 13 0 0 15 3 24 23 77 8 20 0 0 6 0 0 14 43 30 15
0 0 0 2 0 32 0 11 0 0 12 0 0 13 12 0 7 9 25 1 0 8 9 7 0 3 3 0 9 0 1 13 4 0 9 24 7 15 0 0 27 0 0 35 10 11
0 14 7 0 5 14 1 0 0 7 0 10 0 7 0 7 20 4 1 5 13 0 0 0 19 0 10 0 13 11 6 0 5 13 1 0 41 0 0 0 0 0 0 0 1 0
0 0 0 7 0 0 9 24 0 33 11 21 5 27 13 32 12 0 9 20 10 0 5 14 7 0 6 5 6 0 0 11 22 14 9 0 5 0 0 0 48 15 33 0 19 2
0 0 0 0 0 0 7 22 0 0 0 24 30 4 0 0 12 6 15 5 0 0 0 10 15 0 0 8 4 4 11 0 4 24 13 0 0 0 0 15 0 0 18 8 0 0
0 3 28 0 51 14 43 27 0 0 0 0 7 0 9 0 0 0 0 4 0 15 0 0 13 6 2 1 3 0 34 0 6 0 4 0 29 0 0 0 12 0 36 47 0 0
0 18 0 0 38 0 0 12 0 4 9 8 0 4 0 0 0 0 5 9 0 0 0 0 18 0 7 11 0 0 0 0 0 2 0 0 0 0 0 0 0 0 38 0 0 0
0 0 9 0 5 19 0 12 0 0 0 46 0 0 0 0 3 15 0 2 34 14 11 0 5 0 10 1 17 0 0 12 31 14 0 6 3 8 14 18 8 2 0 26 0 0
17 7 1 0 0 20 0 11 26 0 0 6 30 0 0 7 0 0 27 15 0 19 20 0 0 22 8 0 3 0 0 0 0 0 9 12 0 11 30 0 0 6 8 0 8 33
19 0 0 13 17 4 0 22 0 44 32 0 0 0 3 0 0 23 0 16 0 0 3 30 4 25 0 0 18 22 0 0 0 0 0 18 0 18 0 30 21 0 17 2 0 0
10 18 18 0 0 34 32 0 0 49 41 0 1 15 6 0 5 9 0 12 25 26 0 13 17 0 13 0 16 0 18 26 0 0 18 16 30 3 3 0 0 0 10 2 16 13
44 1 19 23 19 12 0 17 20 0 23 24 11 8 2 0 0 0 5 14 13 0 8 13 23 7 23 12 0 9 8 20 1 14 0 41 0 0 0 0 0 0 16 10 15 21
0 33 0 0 19 14 1 0 0 31 35 10 7 0 7 0 10 8 0 50 0 9 14 36 21 0 0 0 0 5 15 0 22 3 33 1 16 0 0 0 19 0 0 16 11 1
0 18 26 0 0 11 0 24 15 0 12 0 38 14 0 2 14 6 26 9 18 5 18 21 5 0 24 28 9 0 13 39 0 15 16 41 15 0 0 15 6 0 15 0 0 0
