44 25
0 33 3 0 31 0 0 0 0 1 16 0 0 23 0 14 0 0 5 6 0 0 2 0 0 19 16 0 6 25 0 6 19 0 10 10 0 0 18 0 18 0 0 15
72 56 15 7 15 7 0 22 11 27 1 14 0 0 9 0 0 15 17 4 8 20 0 33 0 18 0 12 6 8 0 0 32 6 7 3 0 0 16 9 0 40 0 24
0 0 10 0 22 21 21 1 0 4 5 0 18 3 0 18 3 0 0 0 8 0 23 13 0 0 0 14 5 0 6 7 0 18 8 1 0 0 7 10 4 18 0 0
0 0 8 0 9 52 21 44 0 19 18 0 8 9 16 0 10 0 11 24 0 4 30 0 5 20 22 13 0 12 9 0 27 0 0 19 0 0 3 0 0 0 16 17
0 2 4 18 0 0 15 0 0 8 0 17 15 15 0 0 8 2 9 8 0 0 14 0 0 0 0 15 19 7 2 0 8 3 5 0 10 0 22 0 0 17 0 9
6 2 1 8 15 0 29 0 0 0 12 16 0 46 8 0 22 5 5 15 9 7 16 6 8 0 0 7 7 19 0 8 1 0 0 51 0 0 47 8 0 0 16 0
11 0 14 0 57 0 0 0 32 0 1 5 8 31 7 24 0 25 0 22 8 0 19 16 16 0 0 14 15 1 0 8 0 3 1 3 32 0 12 11 63 3 25 0
35 5 6 18 3 2 30 32 0 0 8 9 0 0 9 1 16 0 16 33 2 38 27 37 0 0 0 0 0 1 12 12 0 6 0 17 66 1 0 6 4 0 0 47
0 9 4 19 27 13 0 9 41 24 0 11 0 0 1 2 1 11 0 0 32 9 14 0 0 0 0 0 0 58 7 0 8 11 1 2 42 12 9 0 2 1 0 23
42 9 0 16 33 0 8 0 33 0 31 0 0 31 0 0 21 12 0 0 4 0 5 17 4 0 0 3 0 10 5 0 11 12 0 25 0 11 0 6 0 1 0 43
1 41 40 55 0 0 0 0 0 11 16 34 20 21 28 11 25 0 10 0 10 21 7 9 0 0 23 17 35 13 9 0 12 5 21 15 36 37 0 9 3 9 52 32
66 0 19 16 30 38 0 11 0 7 0 7 0 13 0 0 0 1 6 8 0 3 0 5 31 0 0 5 8 0 0 0 33 0 30 35 0 0 0 6 3 0 0 3
3 38 3 38 0 18 0 16 7 8 9 1 0 6 0 0 26 5 6 1 14 0 0 37 9 0 11 1 0 3 7 11 10 6 14 32 11 0 0 10 39 0 18 0
35 39 0 2 0 21 4 0 35 0 0 47 2 15 3 4 5 12 5 7 0 0 11 0 0 8 0 13 28 13 9 7 0 8 18 0 7 32 27 0 14 0 0 40
0 30 2 19 0 11 23 4 14 0 45 0 0 27 13 0 0 0 5 0 0 7 4 1 13 0 0 25 5 42 0 0 19 2 0 2 7 23 0 11 0 0 39 30
0 0 3 36 0 0 14 0 0 0 0 0 2 0 0 0 0 0 10 2 0 2 6 20 18 21 0 24 0 12 0 1 0 0 0 0 0 0 5 4 0 0 0 7
5 0 2 0 7 0 0 0 4 6 0 4 0 0 0 3 0 0 4 0 0 0 6 0 0 1 0 3 0 0 8 0 0 0 0 0 0 0 0 0 0 0 0 0
6 9 9 5 0 0 32 3 0 4 0 9 5 3 5 0 0 0 0 0 0 9 26 10 0 3 4 0 6 10 0 30 0 26 0 4 0 4 9 42 0 0 36 0
0 8 5 38 38 10 0 6 3 14 22 7 22 17 5 0 14 0 6 0 0 0 0 0 7 0 1 5 1 1 11 3 2 0 26 0 0 0 0 7 0 40 38 2
0 63 0 32 0 2 11 0 0 7 0 26 14 0 24 1 7 0 6 3 21 0 5 0 12 0 0 16 8 0 0 0 0 0 0 15 21 56 0 0 18 11 0 0
42 10 5 85 2 0 0 10 0 46 12 0 0 0 18 0 0 26 0 4 5 22 12 16 0 21 3 0 0 0 0 4 46 1 0 0 0 14 15 0 3 0 34 1
0 0 11 9 39 13 48 0 2 9 43 16 4 18 20 22 19 12 9 25 7 20 31 0 9 0 0 29 11 0 21 0 11 17 1 0 3 3 47 34 0 25 1 32
8 3 0 53 14 0 0 0 30 16 29 0 0 5 19 0 12 0 0 10 0 0 20 0 24 0 18 0 0 0 21 0 31 23 0 23 0 0 0 54 24 0 0 40
12 24 0 71 17 30 0 2 28 40 43 0 0 1 13 0 0 25 0 0 0 6 19 15 15 0 15 6 17 0 0 9 20 0 5 42 14 0 0 5 5 38 57 0
0 0 5 13 1 25 0 5 0 4 0 0 0 6 2 0 13 0 0 16 0 0 0 25 0 0 0 14 0 14 0 4 29 0 0 15 28 0 33 0 0 0 14 14
